Project Quest
An Interactive Fiction by ITIS-3300 Fall 2020 Group 2
Release 1 / Serial number 200926 / Inform 7 build 6M62 (I6/v6.33 lib 6/12N) SD

Conference room
You are a student in Professor Cynthia Burke's Software Requirements and Project Management class at UNC Charlotte. Presently you are in a classroom awaiting a quiz on Project Scope management. You are sitting at a desk with other students around you, and the professor is standing in front of a podium in the front of the class. Your computer which you will be using to take the quiz is right in front of you. There is a door to the South.

The professor has asked if anyone wants another quick rundown on scope before the quiz. Go east to start the quiz.

(DEBUG "examine the leaflet, ask professor burke about the project, examine computer, south, s, east, e")

Professor Burke stands patiently waiting for you to do something...

You can also see a computer and a leaflet here.

>say hello to professor burke
There is no reply.

>examine professor burke
Professor bruke stands patiently waiting for you to do something...

>ask professor burke about the project
Professor Burke says that you should be much further along than you currently are.

>examine leaflet
Welcome to the group project for ITIS-3300 Fall 2020 group 2.  During which you will create a project plan using standard project management methods.  You will be scored for your decisions.  Good luck!

>examine clipboard
It's just an empty clipboard.

>get clipboard
Taken.

>get leaflet
Taken.

>get professor burke
I don't suppose Professor Burke would care for that.

* * *

>examine table
You can't see any such thing.

>examine clipboard
It's just an empty clipboard.

* * *

>examine clipboard
It's just an empty clipboard.

>get clipboard
Excellent.

[Your score has just gone up by two points.]

>read leaflet
Welcome to the group project for ITIS-3300 Fall 2020 group 2.  During which you will create a project plan using standard project management methods.  You will be scored for your decisions.  Good luck!

>get leaflet
You have earned 1 point.

[Your score has just gone up by one point.]

>Examine professor burke
Professor bruke stands patiently waiting for you to do something...

>ask professor burke about the project
Professor Burke says that you should be much further along than you currently are.

* * *

>get clipbaord
You can't see any such thing.

>get clipboard
You have the clipboard, this will be heplful to keep papers organized.

[Your score has just gone up by two points.]

>examine leafelt
You can't see any such thing.

>examine leaflet
Welcome to the group project for ITIS-3300 Fall 2020 group 2.  During which you will create a project plan using standard project management methods.  You will be scored for your decisions.  Good luck!

Nice.

[Your score has just gone up by one point.]

>get leaflet
Taken.

>examine professor burke
Professor bruke stands patiently waiting for you to do something...

>ask professor burke about the project
Professor Burke says that you should be much further along than you currently are.
Well done.

[Your score has just gone up by two points.]

>score
You have so far scored 5 out of a possible 100, in 6 turns.

>s
hallway
This is a hallway outside the conference room.  The hallway leads further South and East.  The conference room is North.

>s
stairwell
A side stairwell that only leads down.  To the North is the hallway.

>d
basement
A dark and damp basement with empty cardboard boxes in various stages of decay.  Any attempt to touch the boxes results in it failing to old, shredded pieces.  A stairwell leads up from here.

>u
stairwell
A side stairwell that only leads down.  To the North is the hallway.

>n
hallway
This is a hallway outside the conference room.  The hallway leads further South and East.  The conference room is North.

>n
Conference room
You are standing in a rather unappealing conference room.  There is a table in the middle of the room.  There is a door to the South.

You can see Professor Burke here.

* * *

>ask professor burke about the project
To put it simply, scope is the defined functions of a product. What the product does, what it doesn't do etc. Early on in any project, this would be defined based on available resources, and the desires of the stakeholders, or those who would benefit from the project's completion. It is important to decide this first, and very clearly, as scope creep can and does kill projects when they try to do too many things. Scope is often defined in a process called mind mapping in which the project builders start with an idea and build outwards from that. Overall it is simply important that scope is clear from the beginning. With that, I believe we have to start the quiz now.

Professor Burke says that you should be much further along than you currently are.
Well done.

[Your score has just gone up by two points.]

>get computer
Taken.

>examine computer
It's just a computer, I think it's  Kaypro?

Oh?  You've used a computer before?  This should be heplful to you.

[Your score has just gone up by two points.]

>read leaflet
Welcome to ProjectQuest version 1.0! This game is a text-based adventure designed to help students practice their understanding of software project management. In this first version the focus is project scope management.  You will be scored for your decisions.  Good luck!

[Your score has just gone up by one point.]

* * *

>read leaflet
Welcome to ProjectQuest version 1.0! This game is a text-based adventure designed to help students practice their understanding of software project management. In this first version the focus is project scope management.  You will be scored for your decisions.

The game presents the user with a scenario via text, and the user can react by typing what they wish to do into the console. For example, if the game told you there is a sandwich in front of you, you might type "eat sandwich" or "eat the sandwich". The inputs are not case sensitive, so do not worry about that, however, try to avoid adding too much beyond exactly what you wish to do to avoid confusing the game. If you make a wrong input do not worry though, as the game will just repeat what it just told you again.

We hope you enjoy and learn from this version of Project Quest!

Good luck!

[Your score has just gone up by one point.]

* * *

I beg your pardon?

>s
hallway
This is a hallway outside the conference room.  The hallway leads further South and East.  The conference room is North.

>n
Conference room
You are a student in Professor Cynthia Burke's Software Requirements and Project Management class at UNC Charlotte. Presently you are in a classroom awaiting a quiz on Project Scope management. You are sitting at a desk with other students around you, and the professor is standing in front of a podium in the front of the class. Your computer which you will be using to take the quiz is right in front of you. There is a door to the South.

The professor has asked if anyone wants another quick rundown on scope before the quiz. If not, she will start the quiz. What do you do, start the quiz, or ask the professor?

Professor Burke stands patiently waiting for you to do something...

You can also see a computer and a leaflet here.

* * *

>get leaflet
Taken.

>read leaflet
Welcome to ProjectQuest version 1.0! This game is a text-based adventure designed to help students practice their understanding of software project management. In this first version the focus is project scope management.  You will be scored for your decisions.

The game presents the user with a scenario via text, and the user can react by typing what they wish to do into the console. For example, if the game told you there is a sandwich in front of you, you might type "eat sandwich" or "eat the sandwich". The inputs are not case sensitive, so do not worry about that, however, try to avoid adding too much beyond exactly what you wish to do to avoid confusing the game. If you make a wrong input do not worry though, as the game will just repeat what it just told you again.

We hope you enjoy and learn from this version of Project Quest!

Good luck!

[Your score has just gone up by one point.]

>examine computer
It's just a computer, I think it's  Kaypro?

Oh?  You've used a computer before?  This should be heplful to you.

[Your score has just gone up by two points.]

>talk to professor burke
I didn't understand that sentence.

>ask professor burke
(for the leaflet)
(Professor Burke first taking the leaflet)
Professor Burke has better things to do.

>i
You are carrying:
  a leaflet

>ask professor burke about the project
To put it simply, scope is the defined functions of a product. What the product does, what it doesn't do etc. Early on in any project, this would be defined based on available resources, and the desires of the stakeholders, or those who would benefit from the project's completion. It is important to decide this first, and very clearly, as scope creep can and does kill projects when they try to do too many things.

Scope is often defined in a process called mind mapping in which the project builders start with an idea and build outwards from that. Overall it is simply important that scope is clear from the beginning.

With that, I believe we have to start the quiz now.
Well done.

[Your score has just gone up by two points.]

>l
Conference room
You are a student in Professor Cynthia Burke's Software Requirements and Project Management class at UNC Charlotte. Presently you are in a classroom awaiting a quiz on Project Scope management. You are sitting at a desk with other students around you, and the professor is standing in front of a podium in the front of the class. Your computer which you will be using to take the quiz is right in front of you. There is a door to the South.

The professor has asked if anyone wants another quick rundown on scope before the quiz. If not, she will start the quiz. What do you do, start the quiz, or ask the professor?

Professor Burke stands patiently waiting for you to do something...

You can also see a computer here.

>lab
I didn't understand that sentence.

>enter lab
You can't see any such thing.

>n
You can't go that way.

>e
You can't go that way.

>w
You can't go that way.

* * *

>s
hallway
This is a hallway outside the conference room.  The hallway leads further South and East.  The conference room is North.

>e
Lab
You can see Sam here.

Sam asks you, "In what year was Delaware admitted into the Union?"

>1985
Wrong!

I beg your pardon?

I beg your pardon?

>l
Lab
You can see Sam here.

Sam asks you, "In what year was Florida admitted into the Union?"

>1845
Correct! (March 3rd, to be exact!)

[Your score has just gone up by one point.]

* * *

>examine leafelt
You can't see any such thing.

>examine leaflet
Welcome to ProjectQuest version 1.0! This game is a text-based adventure designed to help students practice their understanding of software project management. In this first version the focus is project scope management.  You will be scored for your decisions.

The game presents the user with a scenario via text, and the user can react by typing what they wish to do into the console. For example, if the game told you there is a sandwich in front of you, you might type "eat sandwich" or "eat the sandwich". The inputs are not case sensitive, so do not worry about that, however, try to avoid adding too much beyond exactly what you wish to do to avoid confusing the game. If you make a wrong input do not worry though, as the game will just repeat what it just told you again.

We hope you enjoy and learn from this version of Project Quest!

Good luck!

[Your score has just gone up by one point.]

>examine computer
It's just a computer, I think it's  Kaypro?

Oh?  You've used a computer before?  This should be heplful to you.

[Your score has just gone up by two points.]

>ask professor burke about the project
To put it simply, scope is the defined functions of a product. What the product does, what it doesn't do etc. Early on in any project, this would be defined based on available resources, and the desires of the stakeholders, or those who would benefit from the project's completion. It is important to decide this first, and very clearly, as scope creep can and does kill projects when they try to do too many things.

Scope is often defined in a process called mind mapping in which the project builders start with an idea and build outwards from that. Overall it is simply important that scope is clear from the beginning.

With that, I believe we have to start the quiz now.
Well done.

[Your score has just gone up by two points.]

>e
quiz
You can see Sam here.

Sam asks you, "In what year was Hawaii admitted into the Union?"

>1987
Wrong!

Sam asks you, "In what year was Florida admitted into the Union?"

>1457
Wrong!

Sam asks you, "In what year was Delaware admitted into the Union?"

>1960
Wrong!

Sam asks you, "In what year was Delaware admitted into the Union?"

>1787
Correct! (December 7th, to be exact!)

[Your score has just gone up by one point.]

>l
quiz
You can see Sam here.

* * *

>e
quiz
You can see Sam here.

Sam asks you, "In what year was Florida admitted into the Union?"

>1998
Wrong!

Sam asks you, "In what year was Delaware admitted into the Union?"

>1665
Wrong!

Sam asks you, "In what year was Delaware admitted into the Union?"

>1455
Wrong!

I beg your pardon?

>l
quiz
You can see Sam here.

Sam asks you, "In what year was Delaware admitted into the Union?"

>1587
Wrong!

>test
>--> The following tests are available:
'test me'

>test me
(Testing.)

>[1] 1845
I didn't understand that sentence.

>[2] z
Time passes.

Sam asks you, "In what year was Hawaii admitted into the Union?"

>[3] z
(ignoring the question)

Time passes.

Sam asks you, "In what year was Florida admitted into the Union?"

>[4] 1787
Wrong!

>[5] 1792
I didn't understand that sentence.

>[6] z
Time passes.

Sam asks you, "In what year was Hawaii admitted into the Union?"

>[7] 1845
Wrong!

>[8] g
I didn't understand that sentence.

>table
I didn't understand that sentence.

>Test me with "1845 / z / z / 1787 / 1792 / z / 1845 / g".
I only understood you as far as wanting to test that.

* * *

>e
quiz
You can see Sam here.

Sam asks you, "In what year was Florida admitted into the Union?"

>1845
Correct! (March 3rd, to be exact!)

Sam asks you, "In what year was Delaware admitted into the Union?" (topic entry)
[Your score has just gone up by one point.]

* * *

>e
quiz
You can see Sam here.

Sam asks you, "In what year was Florida admitted into the Union?"

>examine sam
(ignoring the question)

Sam says he is going to ask you some questions, just type your answers. Type look or l for me to ask another question.

(DEBUG "1845, 1787, 1960")

Sam asks you, "In what year was Florida admitted into the Union?"

>l
(ignoring the question)

quiz
You can see Sam here.

Sam asks you, "In what year was Delaware admitted into the Union?"

>l
(ignoring the question)

quiz
You can see Sam here.

Sam asks you, "In what year was Hawaii admitted into the Union?"

>l
(ignoring the question)

quiz
You can see Sam here.

Sam asks you, "In what year was Delaware admitted into the Union?"

>l
(ignoring the question)

quiz
You can see Sam here.

Sam asks you, "In what year was Florida admitted into the Union?"

>l
(ignoring the question)

quiz
You can see Sam here.

Sam asks you, "In what year was Florida admitted into the Union?"

>l
(ignoring the question)

quiz
You can see Sam here.

Sam asks you, "In what year was Hawaii admitted into the Union?"

* * *

>l
(ignoring the question)

quiz
You can see Sam here.

Sam asks you, "In what year was Delaware admitted into the Union?"

I beg your pardon?

>l
(ignoring the question)

quiz
You can see Sam here.

Sam asks you, "In what year was Delaware admitted into the Union?"

* * *

I beg your pardon?

>quit
Are you sure you want to quit?